############
#          ##   ####
# ######## ######  #
# ##     #         #
# ## ###   ######$ #
# ## # ## $   $   ##
# ## # ##  ##### ##
# ## ####   $ $  #
# ## ### $ ## @ ##
# # $ ##  #######
# $   ...**.#
########....#
       ######