   ######
   # ...#
####....#
#  ###$ ###
# $ $  $$ #
#@ $ $    #
#   ###   #
##### #####