 #######
 #.... #
###...$###
#  $#$ $ #
# $$  #$ #
#    #   #
#### @ ###
   #####