   ######
 ###    #
##. $## ##
#..$ $  @#
#.. $ $ ##
######  #
     ####