 #######
 #     ###
##$###   #
# @ $  $ #
# ..# $ ##
##..#   #
 ########