   #######
####     #
#   .### #
# # #    ##
# # $ $#. #
# #  *  # #
# .#$ $ # #
##    # # ###
 # ###.    @#
 #     ##   #
 ############