  ######
  #    #
###$$$ #
#@ $.. #
# $...##
####  #
   ####