 #####
 #  ###
 #@$  #
### # ##
#.# #  #
#.$  # #
#.   $ #
########